8 13
0110010000000
1100101110100
1001101000100
1100101110100
1000100010000
1010111011001
0000001010000
1001101111101
0001001100100